Guk,GukTop,-224,364,698,419,1150,1792
L,line,gray,141,-194,1191,-193,1149,-167,1149,-151,1118,-137,1078,-135,1048,-114,1035,-113,996,-109,965,-109,941,-95,924,-95,911,-68,911,-55,898,-53,798,-69,802,-71,786,-66,773,-55,771,-40,714,-53,644,-39,588,-68,531,-82,489,-110,427,-130,428,-148,424,-151,420,-152,405,-178,395,-208,376,-235,389,-236,377,-252,377,-252,390,-277,390,-277,377,-293,376,-294,418,-307,418,-308,432,-336,432,-336,463,-322,463,-305,449,-284,449,-280,464,-266,463,-266,474,-280,475,-280,488,-307,488,-321,475,-347,474,-347,421,-319,420,-320,377,-333,376,-333,351,-320,351,-319,335,-333,334,-334,195,-350,195,-350,223,-391,227,-392,261,-397,264,-488,264,-494,261,-493,163,-488,159,-454,160,-453,155,-459,154,-460,135,-473,125,-473,101,-462,101,-462,112,-420,113,-420,116,-412,117,-411,109,-372,109,-372,116,-363,116,-357,97,-334,58,-333,43,-343,27,-344,18,-359,4,-367,3,-367,-27,-349,-51,-324,-42,-324,-32,-307,-27,-296,-34,-287,-43,-287,-57,-263,-96,-246,-96,-227,-76,-232,-60,-232,-36,-238,-30,-238,9,-229,7,-229,-13,-214,-33,-202,-34,-162,-41,-152,-53,-140,-53,-113,-40,-112,-14,-127,1,-138,6,-151,-6,-151,-13,-160,-24,-181,-22,-188,-11,-188,0,-182,13,-182,22,-173,32,-168,47,-170,49,-162, 59,-155,70,-145,60,-138,50,-133,52,-124,61,-126,70,-140,79,-135,88,-134,102
L,line,gray,20,-72,142,-67,127,-57,122,-51,122,-38,129,-14,155,13,155,15,124,-12,124,-25,111,-26,85,0,85,1,42,-12,27,-26,27,-26,1,1,-12,2,-39,30,-42,30,-67
L,line,gray,41,41,-54,41,-30,13,-28,27,1,27,27,13,30,13,86,27,98,29,156,41,168,57,179,57,197,46,205,41,205,38,209,28,209,41,224,41,265,28,279,0,280,0,307,-12,307,-12,281,-26,279,-28,293,-41,306,-56,320,-55,323,-42,331,-42,364,-26,351,-26,322,-13,309,0,308,28,309,29,304,25,301,25,286,28,283,42,283,30,279
L,line,gray,25,42,267,57,271,57,293,53,297,48,297,43,293,40,293,40,306,41,306,41,309,54,322,112,365,124,365,125,344,128,341,154,341,155,333,145,321,84,321,71,307,71,295,98,295,99,267,71,251,45,251
L,line,gray,97,45,239,71,238,71,212,84,197,153,197,153,210,168,211,156,183,147,181,147,161,195,155,195,167,182,167,181,183,193,183,195,195,182,209,181,223,157,223,157,222,154,221,153,253,140,265,112,265,111,294,125,304,125,307,145,309,149,300,154,295,176,295,181,298,181,329,173,337,168,339,167,357,163,361,140,361,178,365,181,448,192,448,208,437,237,435,237,447,224,447,223,461,209,476,223,504,209,532,209,576,196,585,194,585,193,588,209,589,209,589,213,590,213,589,251,589,251,699,238,712,237,729,279,729,279,769,239,769,239,743,240,743,241,741,238,740,237,741,234,741,225,714,211,699,211,603,212,603,213,600,209,600,209,601,180,601,177,599,177,590,182,589,183,586,169,585,169,573,154,559,14,559,13,573,0,573,0,585,-1,585,-2,588,0,589,0,590,-12,601,-12,600,-16,600,-16,601
L,line,gray,30,42,547,181,547,181,574,195,575,197,532,172,531,169,517,141,503,141,476,169,448,154,391,140,391,139,413,130,419,99,419,99,393,112,393,113,379,57,349,55,378,83,379,83,405,57,405,49,386,29,390,15,391,15,378,0,377,-14,391,-14,446
L,line,gray,17,-40,448,-40,420,-26,406,-26,392,-12,379,-54,377,-54,336,-57,335,-58,363,-110,363,-110,322,-83,295,-56,296,-56,308,-43,309,-44,312,-55,320
L,line,gray,9,22,205,17,230,22,237,24,252,15,261,0,261,-8,252,-7,237,-1,230
L,line,gray,2,-12,249,-43,256
L,line,gray,2,20,253,34,271
L,line,gray,9,15,210,19,199,38,193,39,187,29,181,15,167,-68,167,-68,154,-95,153
L,line,gray,76,-305,84,-322,92,-322,113,-336,125,-346,128,-359,136,-364,127,-366,127,-371,127,-372,135,-373,135,-378,133,-412,135,-412,129,-417,127,-420,155,-429,155,-432,159,-397,159,-392,163,-392,218,-372,217,-363,211,-362,183,-322,183,-322,308,-307,309,-306,294,-320,293,-320,267,-292,253,-306,237,-306,197,-294,197,-294,224,-252,249,-251,253,-237,253,-209,267,-196,280,-196,294,-210,338,-210,350,-201,351,-178,362,-144,387,-140,406,-112,407,-84,421,-84,462,-27,463,41,519,43,490,70,463,71,421,28,377,-12,363,-14,373,-38,397,-62,405,-85,405,-104,401,-124,391,-124,364,-138,363,-142,364,-153,364,-162,357,-158,342,-143,342,-142,350,-125,351,-124,308,-141,305,-142,308,-159,308
L,line,gray,130,-170,297,-171,286,-155,281,-142,289,-142,294,-125,295,-110,281,-96,280,-95,265,-108,263,-108,247,-98,237,-85,237,-78,246,-78,257,-83,263,-84,263,-84,279,-70,281,-68,267,-74,257,-74,235,-53,235,-46,242,-46,252,-48,257,-54,263,-55,263,-56,280,-28,295,-14,309,14,295,42,295,69,309,124,323,127,253,141,223,141,197,148,197,149,194,141,193,141,183,99,181,99,141,140,141,141,43,167,43,167,56,196,57,224,29,225,15,217,7,209,-2,183,0,179,-7,179,-21,183,-26,198,-28,210,-26,230,-9,235,-2,235,29,241,29,241,1,252,1,253,-26,293,-26,293,-1,307,1,307,13,253,13,251,27,279,56,294,57,295,29,321,29,321,55,307,55,307,67,280,67,279,72,307,73,307,84,321,85,321,111,295,111,294,83,281,83,251,111,251,126,279,127,279,153,253,153,253,141,244,138,241,112,235,111,235,139,225,139,225,112,196,83,167,84,167,140,209,141,209,181,168,181,167,193,160,193,159,197,173,203,167,209,167,237,154,250,153,257,149,264,140,296,153,308,153,322,195,350,195,391,223,414,223,463,265,477,265,559,251,573,251,615,224,628,223,671,197,671,197,658
L,line,gray,10,197,658,167,628,167,645,195,672,195,698,168,684,142,645,141,631,127,600,127,575
L,line,gray,11,126,349,42,307,13,321,-14,321,-14,350,32,367,37,370,83,406,83,475,55,489,55,518
L,line,gray,20,43,545,-27,489,-52,489,-56,531,-28,574,-28,601,-42,645,-19,691,-14,727,-42,771,-54,780,-42,785,-28,792,-28,797,-18,803,-5,800,13,799,66,812,112,813,113,785
L,line,gray,35,123,784,125,825,69,824,29,811,14,811,27,868,41,892,13,923,13,925,26,937,73,939,81,950,78,962,68,978,55,992,111,1022,110,1031,98,1048,97,1050,78,1070,85,1079,93,1091,97,1137,71,1159,69,1169,67,1177,55,1207,36,1221,33,1236,29,1255,21,1289,38,1325,61,1337,79,1354,83,1373
L,line,gray,19,71,1372,67,1361,38,1346,14,1331,-23,1306,-37,1316,-55,1326,-45,1350,-26,1356,-8,1357,12,1355,19,1359,28,1371,45,1380,51,1390,53,1395,55,1431,57,1450,70,1457
L,line,gray,42,83,1471,71,1474,57,1464,45,1440,33,1434,40,1439,31,1462,29,1483,29,1502,27,1511,69,1513,69,1538,41,1538,15,1525,15,1513,13,1501,13,1485,8,1458,3,1436,0,1417,0,1403,-4,1397,0,1385,3,1380,-3,1372,-6,1372,-42,1370,-74,1357,-83,1337,-71,1316,-64,1300,-91,1281,-130,1264,-139,1276,-153,1286,-161,1286,-173,1282,-187,1267,-187,1250,-167,1233,-166,1175,-179,1162
L,line,gray,2,-182,1202,-182,1161
L,line,gray,6,-277,291,-277,291,-276,310,-294,311,-296,293,-277,291
L,line,gray,6,-235,291,-235,291,-234,308,-253,310,-254,293,-235,291
L,line,gray,6,-235,334,-235,334,-234,351,-252,353,-254,335,-235,333
L,line,gray,6,-277,352,-277,352,-294,353,-296,335,-278,333,-277,352
L,line,gray,25,-36,924,-36,924,-30,922,-28,912,-10,913,-1,925,0,933,12,938,28,948,35,949,71,949,73,952,71,957,22,984,17,995,-26,1011,-85,1011,-100,995,-100,967,-94,946,-89,936,-86,922,-82,921,-44,922,-36,924
L,line,gray,22,-122,1075,-122,1075,-99,1061,-90,1039,-90,1033,-71,1030,-51,1024,-29,1019,-23,1020,12,1032,19,1033,78,1020,99,1024,90,1038,73,1051,47,1065,6,1075,-32,1086,-80,1115,-135,1121,-124,1088,-122,1075
L,line,gray,24,-156,1174,-156,1174,-116,1163,-92,1138,-88,1134,-44,1104,39,1075,69,1084,81,1101,79,1133,37,1163,37,1188,24,1201,17,1224,3,1241,3,1268,-39,1295,-64,1282,-96,1263,-125,1252,-134,1245,-155,1234,-156,1228,-156,1174
L,line,gray,7,70,1458,70,1458,73,1447,69,1438,67,1394,73,1386,73,1371
L,line,blue,80,378,1645,378,1645,398,1637,407,1632,431,1612,444,1595,483,1572,489,1564,509,1545,520,1550,529,1559,540,1565,553,1571,582,1598,583,1625,564,1625,561,1648,561,1673,575,1665,585,1655,613,1625,613,1607,602,1585,581,1559,569,1551,536,1532,529,1518,545,1480,555,1471,584,1436,585,1426,587,1424,613,1409,630,1389,637,1377,632,1351,624,1343,600,1318,594,1297,589,1292,591,1269,596,1254,599,1222,589,1204,577,1199,565,1193,555,1193,540,1196,534,1207,525,1235,521,1270,534,1285,536,1291,548,1298,563,1298,578,1318,577,1336,590,1347,613,1359,620,1375,611,1380,594,1389,577,1414,562,1417,541,1417,516,1415,490,1421,471,1432,456,1464,456,1464,451,1496,447,1520,448,1525,451,1553,440,1566,412,1582,409,1611,403,1613,392,1615,365,1620
L,line,gray,19,554,1621,554,1621,548,1616,535,1609,521,1608,514,1611,503,1616,483,1614,465,1619,463,1621,449,1677,472,1696,490,1692,498,1686,513,1694,527,1694,535,1690,543,1692,559,1677
L,line,gray,3,554,1621,554,1621,560,1623
L,line,gray,9,543,1414,543,1414,543,1395,543,1361,542,1358,505,1307,505,1297,515,1294,532,1288
L,line,gray,60,520,1275,520,1275,510,1277,498,1290,497,1303,510,1338,524,1351,534,1369,525,1383,520,1387,485,1389,466,1392,444,1397,426,1411,408,1453,386,1471,348,1504,315,1521,275,1530,252,1525,224,1515,221,1470,235,1454,235,1400,269,1398,269,1430,280,1438,291,1434,291,1420,278,1416,278,1369,308,1368,311,1408,322,1410,337,1410,339,1438,344,1438,347,1405,322,1403,319,1372,360,1368,360,1361,320,1360,319,1344,368,1340,374,1333,364,1333,361,1320,353,1320,353,1330,311,1333,311,1359,271,1361,269,1386,268,1387,230,1389,227,1440,209,1444,207,1428,195,1417
L,line,gray,18,171,1441,171,1441,173,1451,183,1452,185,1459,197,1480,213,1510,211,1522,225,1536,243,1532,269,1540,303,1536,328,1527,372,1499,406,1493,422,1521,431,1519,448,1531
L,line,gray,12,547,1255,547,1255,557,1256,567,1251,572,1245,560,1231,549,1233,542,1235,536,1246,534,1250,542,1255,547,1255
L,line,gray,4,531,1287,531,1287,548,1257,549,1255
L,line,gray,3,543,1255,543,1255,520,1275
L,line,gray,16,570,1242,570,1242,598,1237,605,1244,616,1248,624,1251,621,1284,638,1290,646,1287,656,1275,656,1270,637,1245,635,1216,624,1215,603,1220,563,1234
L,line,gray,8,554,1232,554,1232,551,1188,560,1185,558,1178,571,1172,579,1166,585,1160
L,line,gray,16,605,1135,605,1135,605,1140,605,1146,595,1151,586,1150,581,1144,571,1141,569,1141,551,1149,550,1164,549,1174,541,1183,541,1190,545,1198,551,1232
L,line,gray,6,585,1160,585,1160,610,1158,613,1150,613,1143,613,1136
L,line,gray,8,185,1429,185,1429,166,1408,167,1403,168,1396,164,1379,157,1377,168,1350
L,line,gray,9,163,1352,163,1352,154,1378,147,1376,136,1376,126,1385,119,1394,119,1399,84,1422
L,line,gray,9,80,1428,80,1428,121,1407,126,1414,132,1419,145,1420,153,1418,164,1410,182,1430
L,line,gray,3,186,1430,186,1430,165,1406
L,line,gray,94,193,1360,193,1360,193,1350,193,1331,183,1324,164,1315,166,1285,220,1284,221,1259,221,1206,266,1200,306,1200,333,1200,333,1152,335,1144,360,1144,361,1137,362,1117,369,1117,380,1117,387,1116,389,1095,386,1095,367,1095,361,1085,361,1085,307,1067,305,1055,305,1048,326,1047,347,1047,375,1048,393,1045,409,1040,417,1035,421,1027,428,1007,420,989,403,951,403,944,403,905,410,893,458,893,458,857,461,850,472,851,489,836,500,837,531,837,534,842,522,854,529,861,535,856,539,850,543,838,532,803,527,812,528,817,535,824,533,828,494,829,487,828,487,810,487,810,513,809,515,803,515,785,517,780,529,781,529,770,536,754,543,719,540,710,533,696,529,676,516,647,515,644,515,630,504,609,494,597,465,591,449,605,431,597,422,592,416,593,391,607,378,619,363,619,341,619,323,609,319,588,319,555,318,549,266,549
L,line,gray,73,267,557,267,557,277,557,292,557,297,566,298,570,308,583,311,597,320,623,337,627,376,640,392,654,407,654,428,643,445,629,461,613,492,613,500,629,518,678,534,725,523,769,521,773,507,773,493,773,493,779,499,781,507,785,507,798,492,802,474,787,460,787,459,761,430,759,423,773,416,774,413,766,409,760,409,772,409,778,422,781,431,778,431,768,449,767,452,783,417,815,397,813,390,814,389,807,385,807,379,815,351,815,347,813,346,794,324,787,263,786,264,768,288,767,291,734,255,731,254,786,210,787,207,719,196,717,193,700,167,685,138,641,136,627,125,602,125,602,123,575,96,532,57,521,53,518
L,line,gray,61,44,543,44,543,97,586,109,607,128,656,168,724,179,726,194,725,199,727,199,763,199,795,209,795,234,795,332,795,338,796,339,817,378,823,381,831,384,827,389,825,402,823,423,824,431,832,450,851,451,881,443,885,395,885,395,901,395,940,406,984,412,1005,397,1014,386,1023,362,1035,303,1039,297,1043,295,1059,292,1068,286,1068,283,1091,275,1095,256,1095,255,1117,264,1116,275,1116,282,1117,283,1144,309,1144,313,1151,311,1175,261,1179,219,1179,199,1179,199,1207,199,1260,165,1263,143,1315,115,1320,110,1323,101,1351,101,1357
L,line,blue,91,95,1362,95,1362,92,1345,92,1341,91,1327,94,1317,101,1285,121,1240,137,1213,157,1189,175,1160,191,1139,191,1128,213,1094,213,1094,239,1041,239,1010,238,988,229,973,229,944,233,929,235,894,223,872,221,852,207,830,193,813,170,801,161,792,158,761,161,758,169,735,175,737,179,736,169,731,146,698,133,676,129,675,129,712,129,763,115,775,109,760,109,750,109,676,95,625,95,591,49,555,45,557,36,587,19,639,17,678,17,711,21,716,40,735,53,758,75,773,101,781,108,781,126,779,145,790,156,795,180,820,197,861,205,896,209,911,203,943,203,975,203,1002,206,1023,206,1029,197,1062,192,1075,175,1103,134,1169,112,1207,100,1227,80,1256,70,1307,73,1323,87,1353,87,1366,87,1392,87,1444,95,1448,119,1470,93,1490,78,1490,69,1489,28,1488,0,1488,-16,1492,-25,1496
L,line,blue,20,-19,1513,-19,1514,-2,1499,30,1498,56,1500,74,1503,93,1503,99,1501,129,1478,135,1466,137,1455,143,1448,162,1440,185,1420,193,1391,193,1365,188,1362,152,1353,119,1356,95,1362
L,line,gray,4,122,790,122,790,123,759,124,660
L,line,gray,6,98,595,98,595,99,625,110,665,113,763,114,781
L,line,gray,4,81,1469,81,1469,90,1464,96,1450
L,line,blue,6,-80,1533,-80,1533,-74,1520,-55,1512,-36,1503,-26,1497
L,line,blue,6,-20,1514,-20,1514,-41,1523,-62,1536,-64,1537,-67,1539
M,water,blue,98,-36,162,-108,-36,162,-108,-46,165,-108,-53,165,-108,-57,154,-106,-67,154,-87,-70,151,-138,-97,152,-158,-107,152,-148,-113,167,-148,-119,177,-148,-119,188,-148,-131,205,-158,-139,216,-158,-152,207,-168,-161,193,-168,-161,169,-168,-169,156,-149,-177,149,-148,-177,143,-148,-170,137,-148,-173,132,-148,-162,122,-168,-154,120,-168,-147,119,-168,-145,110,-148,-155,108,-148,-167,110,-148,-180,110,-148,-189,116,-148,-196,124,-148,-211,140,-148,-210,145,-148,-196,155,-168,-196,205,-168,-204,218,-158,-210,236,-157,-235,236,-154,-235,225,-158,-220,209,-158,-221,197,-153,-208,195,-158,-207,182,-158,-236,153,-158,-264,166,-156,-269,157,-168,-269,146,-168,-263,140,-149,-263,127,-148,-249,112,-158,-264,101,-178,-286,100,-154,-292,97,-158,-305,84,-128,-307,72,-108,-292,57,-158,-286,49,-164,-279,44,-169,-272,45,-160,-266,56,-168,-266,84,-198,-247,86,-178,-239,89,-178,-239,131,-148,-224,141,-158,-225,118,-148,-222,114,-148,-209,114,-148,-194,99,-148,-189,87,-107,-183,84,-108,-156,84,-108,-147,85,-108,-139,89,-108,-135,94,-108,-135,104,-148,-127,109,-168,-127,115,-168,-132,123,-168,-140,128,-168,-151,128,-168,-147,136,-148,-148,141,-148,-148,149,-148,-141,150,-148,-139,169,-159,-129,166,-149,-116,137,-148,-111,134,-148,-106,137,-148,-100,138,-158,-98,141,-158,-83,142,-158,-71,143,-138,-67,138,-118,-50,134,-109,-37,146,-108,-36,163,-108
M,bridge,white,3,-59,132,-103,-59,132,-103,-62,153,-87
M,bridge,white,3,-66,154,-86,-66,154,-86,-65,134,-96
M,wall,gray,26,-193,97,-148,-193,97,-148,-193,97,-148,-191,61,-37,-188,57,-98,-180,53,-116,-186,32,-90,-195,22,-106,-200,11,-107,-216,21,-108,-222,31,-107,-236,36,-94,-246,32,-116,-256,17,-125,-257,-11,-126,-277,-28,-129,-280,-13,-107,-290,0,-103,-307,8,-108,-323,0,-91,-329,20,-107,-323,28,-93,-322,56,-108,-313,61,-108,-307,71,-108,-306,83,-112
P,Succor Point,white,7,-36
